111111111111111
100000000000001
1000C0000000001
100000P0000E001
1000000000C0001
111111111111111