
11111111111111111111111111111
1111100000000000C011111110011
11000000000011100000000000111
11111110000000000010001111111
1110000000E000000010000000011
11111100000000011111110000001
111110000000P1111111111110011
11111111111111111111111111111