
11111111111111111111111111111
1000000000000C001111110011001
10000000000011100000000000111
10111110000000000011011111111
1010000000E000000010000000011
10001100000000011111110000001
111110000000P1110001111110011
11111111111111111111111111111