111111111111111111111111111111111111111111111111111
100000000000000000000000000000000000000000000000001
100000000000000000000000000000000000000000000000011
100000000000000000000000000001000000000000000000011
100000000000000000000000000000011111111111111111111
111111111111111110000000000000000000000000000000001
100000000000000000000000000000000111111111111111101
1P1111111111111111111100000000000000000000C00011111
10000000000000000000000011111111111E000000000000001
111111111111111111111111111111111111111111111111111