11111111111111111111111111111111111111111111111111111111
10000000000000000000000000000000000000000000000000000011
10000000000000000000000000000000000000000000000000000011
10000000000000000000000000000100000000000000000000000011
10000000000000000000000000000001111111111111111111111111
11111111111111111000000000000000000000000000000001100001
10000000000000000000000000000000011111111111111111111101
1P1111111111111111111100000000000000000000C0001111111111
10000000000000000000000011111111111E00000000000000000001
11111111111111111111111111111111111111111111111111111111