1111111111111111111111111111111111111111111111111111
11111110P00000C0001111111111111001110000111000111111
111111111111100000111111111111100000000000C000111111
1111111110000000000011111111111000000110000C00000001
1111111111111111100000000000000000001111000C00000001
1111111111111111101111111000111000000111000000111111
1111111111111100001111110000011000000000000000111111
11111111111111000011111100000000011100001110C0111111
1111111111111100111111111000111001110000111000111111
1111111100111100111111110000011000100000111000000011
11111111001111001110000000001111000000C0000011000001
11111111000000001110001100000001100000000001100E0001
1111111111111111111111111111111111111111111111111111