1111111111111111111111111111111111111111111111111111111111111111111
1111111111111111111111111111111111000000000111111111111111111111111
11111111111111111111111111111111C0000000000011111111111111111111111
1111111111111111111111111111111000100000010001111111111111111111111
1111111111111111111111111111111001110000111000111110001111111111111
11111111111110C0001111111111111001110000111000111110C00111111111111
1111111111111000001111111111111000000000000000111110000111111111111
1111111111111111100111111111111000000110000000000000001111111111111
1111111111111111100000000000000000001111000000000000001111111111111
1111111111111111101111111001111000000111000000111111001111111111111
1111111111111100001111110000011000000000000000111111001111111111111
1111111111111100001111110000011001110000111000111111001111111111111
1111111111111100111111111000111001110000111000111111001111111111111
1111111100111100111111110000011000100000111001100000000001111111111
11111111001111001110001110001111000000P0000011000000000001111000111
1111111100001100111000110000000110000000000110000000000000000000011
1111111100000000000000110000000011111001111111111111111000000000111
1111111100000000000000110000110011111001111111111111000001111000011
1111111100001100111000111111111111111000000000000111000001111000111
1111110000001100111000111111111111111000000000000111000001111111111
1111110000111100111111111000000011111001110000000111001111111111111
1111111000111100111111111E00000111111000110011110111001111111111111
1111111110111100111111111111001111100000010011110111001111111111111
1111111111110000001111111111001111000000010000000111001111111111111
1111111111110000000111111111001110000000011111111111000011111111111
1111111111111111100000011000001100011110011111111110001111111111111
1111111111111111100000011000001100011110000000000000001111111111111
1111111111111111101110011001111100111110000000000000001111111111111
111111111111C000001110011001111100111110011111001110001111111111111
1111111111111100001110000000000000011110011111001111001111111111111
1111111111111111111110000000000000001100011111001100C11111111111111
111111111111111111111111111111110000C000010000001111111111111111111
1111111111111111111111111111111110000000010000001111111111111111111
1111111111111111111111111111111111000000010000001111111111111111111
1111111111111111111111111111111111111111111111111111111111111111111
