1111111111111111111111111111111111111111111111111111111111111111
10000011000000000000000000C0000000000000000000000000000000000001
1111000111111111111110000000000000000000000111111111111111100001
1001000P00000000000110000000000000000000000000000000000001100001
1101111110111111100110000000000000000000000111111101111111100001
1100000010000000100110000000000000000000000100000100000000100001
1111111010111110100110000000000000000000000111110111111010111101
1000000010000000100000000000000000000000000000000000001010000001
1011111110111110111111111111111111111111111111111111101010111101
1000000000100000000000000000000000000000000000000000100010000001
1111101110111111111111111111111111111111111111111110101110111101
1000100000000000000000000000000000E00000000000000000001010000001
1010111111111110111111111111111111111111111111111111101011111101
1000000000000010000000000000000000000000000000000000100010000001
1011111111111010111111111111111111111111111111111110101101111101
1000000000000000000000000000000000000000000000000000001000000001
1111111111111111111111111111111111111111111111111111111111111111
