NO ./Include/assets/walls/Texturelabs_Brick_123S.png
SO ./Include/assets/walls/Texturelabs_InkPaint_306S.png
WE ./Include/assets/walls/Texturelabs_Grunge_190S.png
EA ./Include/assets/walls/Texturelabs_Paper_278S.png

F 50,50,50
C 0,0,0

111111111111111111111111111111111111111111111111111111111111
100000000000000000000000000000000000000000000000000000000001
100001111111111000001111111111111000111111111111000111111001
100000000000001000000000000000001000100000000001000100000001
100000000000001111111111111111101000100000000001000100000001
100001111111101000000000000000101000111111111101000111111001
100000000000001000000000000000001000000000000001000000000001
100000000000001000111111111111101000111111111101000000000001
100000000000001000100000000001001000100000000001000000000001
100000111111101000100111111101001000100111111101000111000001
100000100000001000100100000101001000100100000101000100000001
100000100000001000100100000101001000100100000101000100000001
100000111111101000100111111101001000100111111101000111000001
100000000000001000100000000001001000100000000001000000000001
100000000000001000111111111111101000111111111101000000000001
100000000000001000000000000000001000000000000001000000000001
100001111111101000000000000000101000111111111101000111111001
100000000000001111111111111111101000100000000001000100000001
100000000000001000000000000000001000100000000001000100000001
100001111111111000001111111111111000111111111111000111111001
100000000000000000000000000000000000000000000000000000000001
111001111111111111111111111111111111111111111111100000111111
100000000000000000000000000000000000000000000000000000000001
100000111111111111111111111111111111111111111111111110000001
100000100000000000000000000000000000000000000000000000010001
100000100000000000000000000000000000000000000000000000010001
100000100000000000111111111111111111111111111111000000010001
100000000000000000000000000000000000000000000000000000000001
100000111111111111111111111111111111111111111111111111110001
100000100000000000000000000000000000000000000000000000010001
100000100000000000000000000000000000000000000000000000010001
100000000000000000000000000000000000000000000000000000000001
100000111111111111111111111111111111111111111111111111110001
100000100000000000000000000000000000000000000000000000010001
100000100000000000000000000000000000000000000000000000010001
100000000000000000000000000000000000000000000000000000000001
100000111111111111111111111111111111111111111111111111110001
100000100000000000000000000000000000000000000000000000010001
100000100000000000000000000000000000000000000000000000010001
100000000000000000000000000000000000000000000000000000000001
100000111111111111111111111111111111111111111111111111110001
100000100000000000000000000000000000000000000000000000010001
100000100000000000000000000000000000000000000000000000010001
100000000000000000000000000000000000000000000000000000000001
100000111111111111111111111111111111111111111111111111110001
100000100000000000000000000000000000000000000000000000010001
100000100000000000000000000000000000000000000000000000010001
100000000000000000000000000000000000000000000000000000000001
100000111111111111111111111111111111111111111111111111110001
100000100000000000000000000000000000000000000000000000010001
100N00100000000000000000000000000000000000000000000000010001
111111111111111111111111111111111111111111111111111111111111
