NO ./Include/assets/walls/Texturelabs_InkPaint_306S.png
SO ./Include/assets/walls/Texturelabs_Fabric_121S.png
WE ./Include/assets/walls/Texturelabs_Grunge_190S.png
EA ./Include/assets/walls/Texturelabs_Paper_278S.png



F 50,50,50
C 150,150,200

11111111111111111111
10000000010000000001
10000000010000000001
100001001100E0000001
10110000000000000001
1000000000N111000001
10000000100000W00001
1000001111000000N001
100N0000001000000001
11111111111111111111