NO ./Include/assets/walls/Texturelabs_InkPaint_306S.png
SO ./Include/assets/walls/Texturelabs_Fabric_121S.png
WE ./Include/assets/walls/Texturelabs_Grunge_190S.png
EA ./Include/assets/walls/null.png



F 50,50,50
C 150,150,200

11111111111111111111
10000000010000000001
10000000010000000001
10000100110000000001
10110000000000000001
10000000000111000001
1000000010000E000001
10000011110000000001
10000000001000000001
11111111111111111111