1111111111111111111111111111
11111P0000000000000011110001
1000000000001111111010011001
11110000000001C1000010000001
1111110011C00000000000101011
1111110011011110000011100111
10000000000000000E111110C011
1111111111111111111111111111